0
MAP
..###.###..
..# #.# #..
..# #.# #..
###r###@###
#T@     @"#
#####&#####
..# #r# #..
#####r#####
#T      @Y#
###@###@###
..# #.# #..
..#!#.# #..
..###.###..
TILES
@:r
T:1,8
@:r
@:r
T:1,4
@:r
@:r
@:r
@:r
ENEMIES
S:5,8
PLAYER
P:3,1,0
