0
MAP
#######...#########
#     #   #   O   #
#    ~#####   O   #
#                 #
#  b  ##$##       #
#     #   #   !   #
###################
TILES
$:0
ENEMIES
s:1,2:right
W:8,3,left
PLAYER
P:5,5,0